a -> significa 'um'/'uma'.
across -> significa 'entre'.
action -> significa 'ação'.
activity -> significa 'atividade'.
back -> significa 'atrás'.
box -> significa 'caixa'.
branch -> significa 'ramificação'.
change -> significa 'mudança'.
could -> significa 'poderia'.
date -> significa 'data'.
desktop -> significa 'computador de mesa'.
directory -> significa 'diretório'.
file -> significa 'arquivo'.
fine -> significa 'bom'.
free -> significa 'livre'.
here -> significa 'aqui'.
home -> significa 'lar'.
late -> significa 'atrasado'.
lens -> significa 'lente'.
main -> significa 'princinpal'.
mind -> significa 'mente'.
other -> significa 'outro'.
our -> significa 'nosso'/'nossa'.
out -> significa 'fora'.
prime -> significa 'primário'.
provide -> significa 'fornecer'.
prompt -> significa 'induzir'.
recent -> significa 'recente'.
safe -> significa 'seguro'.
say -> significa 'dizer'.
search -> significa 'procura'.
see -> significa 'ver'.
skill -> significa 'habilidade'.
speed -> significa 'velocidade'.
stay -> significa 'ficar'.
table -> significa 'mesa'.
take -> significa 'pega'.
too -> significa 'também'.
up -> significa 'acima'.
we ->  significa 'nós'.
web -> significa 'rede'.
when -> significa 'quando'.
will -> significa 'vai'.
with -> signifca 'com'.
work -> significa 'trabalho'.
you -> significa 'você'.