Roma:

1.Civilização Romana-> A civilização mais importante de antiguitude sobre o mundo ocidental.
Exemplo -> Lingua portuguesa, sistema jurídico e o cristianismo.
latim - lingua romana original.
cristianismo -> Palestina, religião romana -> igreja católica romana.
império -> Estado, governado por um imperador, amplos territórios, poder hergemônico, etinia/culturas distinas.
OBS: O Brasil já foi um império.

2.Arco de constatino -> cenas de vitórias em guerra.
Constatino -> imperador, venceu Maxêncio, unificou roma, buscou parte ocidental do império.
Pompeia -> cidade, perto da Nápoles na itália, erupção vulcânica atingiu ela.

3.Monarquia (sec VI a.C) -> uma pessoa no poder.
Roma -> nasceu no lácio, penísula itálica, povos: etruscos, latinos, sabinos, gregos.
	fundação de roma -> lenda, decentendes do eneias troiano -> fundaram alba longa, amúlio tomou o trono -> jogou remo 	e rômulo no rio numa cesta, amametados por uma lobo, pastor cuidou -> depois matam o amúlio, rômulo mata remo e 	funda roma no monte palatino.
Caracteríticas -> roma teve 7 reis, economia agrícola.
patrícios -> elite social,únicos com privilégios políticos e religiosos, grandes proprietários de terras.
plebeus -> abaixo dos patrícios, homens livres, eram os clientes, prestavam servirços aos patrícios, sem diretos políticos.
escravizados -> mais baixos socialmente, endividados ou vencidos de guerra, em menor número.
ponto de vista político -> rei tinha funçãos executiva judiciais e religiosas, era controlado pelo senado.
Senado -> dominado pelos patrícios,
Assemblei curiata -> cidadões em idade militar, aptos para luta
fim da monarquia -> etruscos impulseram forças militar e políticas,Tarquínio o soberbo último rei etrusco foi deposto por 	uma rebelião liderada por patrícios, todo poder no senado, regime de oligárquias: a República.

4.República (sec VI - I a.C) -> 
governo-> magristrados no poder, senado órgão de poder máximo -> funções legislativas, administração e finanças, grupo 	restritos e eram vitalícios.
magristrados -> pessoas ricas.
	cônsules-> em 2, magristrados mais importantes, propondo as leis, presidindo o Senado e as assembleias.
	ditador -> substituia os cônsules em tempo de guerra.
	pretores -> administravam a justiça
	censores-> contagem e classificação da população apartir da renda.
	edis -> conservação, abastecimento e policiamento da cidade.
	questores -> finanças do governo.
assembleias romanas-> encarregadas da nomeação dos magistrados e da ratificação das leis.
	centurial ->exército de centúrias, votavam as leis.
	curial ->assuntos religiosos
	tribial-> elegiam os magistrados.
