a -> significa 'um'/'uma'.
about -> significa 'sobre'.
across -> significa 'entre'.
action -> significa 'ação'.
activity -> significa 'atividade'.
again -> significa 'denovo'.
ago -> significa 'atrás'.
all -> significa 'tudo'.
and -> significa 'e'.
armor -> significa 'armadura'.
back -> significa 'atrás'.
bag -> significa 'bolsa'.
begin -> significa 'começar'.
best -> significa 'melhor'.
better -> significa 'melhor'.
box -> significa 'caixa'.
body -> significa 'corpo'.
branch -> significa 'ramificação'.
but -> significa 'mas'.
by -> significa 'por'.
change -> significa 'mudança'.
character -> significa 'personagem'.
check -> significa 'checa'.
city -> significa 'cidade'.
close -> significa 'fechar'.
come -> significa 'vir'.
could -> significa 'poderia'.
cover -> significa 'cobrir'
date -> significa 'data'.
day -> significa 'dia'.
desktop -> significa 'computador de mesa'.
direct -> significa 'direto'.
directory -> significa 'diretório'.
down -> significa 'baixo'.
dry -> significa 'seco'.
each -> significa 'cada'
eat -> significa 'comer'.
ever -> significa 'sempre'.
every -> significa 'todo'.
evil -> significa 'mal'.
faint -> significa 'desmaiar'.
far -> significa 'distante'.
fell -> significa 'caiu'.
few -> significa 'poucos'.
file -> significa 'arquivo'.
fire -> significa 'fogo'.
fine -> significa 'bom'.
fly -> significa 'voar'.
free -> significa 'livre'.
follow -> significa 'seguir'.
forest -> significa 'foresta'.
gain -> significa 'gain'.
gate -> significa 'portão'.
get -> significa 'pega'.
give -> significa 'dar'.
go -> significa 'ir'.
gold -> significa 'ouro'.
grass -> significa 'grama'.
growl ->significa 'rosnar'.
have -> significa 'ter'.
heal -> significa 'curar'
hear -> significa 'ouvir'.
here -> significa 'aqui'.
height -> significa 'altura'.
help -> significa 'ajuda'.
hill -> significa 'colina'.
home -> significa 'lar'.
hot -> significa 'quente'.
hour -> significa 'hora'.
house -> significa 'casa'.
how -> significa 'como'.
in -> significa 'em'.
iron -> significa 'ferro'.
join -> significa 'juntar'.
king -> significa 'rei'.
kingdom -> significa 'reino'.
late -> significa 'atrasado'.
learn -> significa 'aprender'.
leech -> significa 'sanguessuga'.
left -> significa 'esquerda'.
length -> significa 'comprimento'.
lens -> significa 'lente'.
let -> significa 'deixar'.
library -> significa 'biblioteca'.
life -> significa 'vida'.
light -> significa 'luz'.
long -> significa 'longo'.
lower -> significa 'menor'.
mage -> significa 'mago'.
main -> significa 'princinpal'.
man -> significa 'homen'.
many -> significa 'muitas'. 
market -> significa 'mercado'.
me -> significa 'mim'.
mind -> significa 'mente'.
moon -> significa 'lua'.
mountain -> significa 'montanha'.
need -> significa 'precisar'.
night -> significa 'noite'.
no -> significa 'não'.
not -> significa 'não'.
now -> significa 'agora'.
on -> significa 'no'.
once -> significa 'uma vez'.
one -> significa '1'.
other -> significa 'outro'.
our -> significa 'nosso'/'nossa'.
out -> significa 'fora'.
people -> significa 'pessoas'.
place -> significa 'lugar'.
pickaxe -> significa 'picareta'.
portion -> significa 'porção'.
power -> significa 'poder'.
prime -> significa 'primário'.
product -> significa 'produto'.
provide -> significa 'fornecer'.
prompt -> significa 'induzir'.
recent -> significa 'recente'.
remember -> significa 'lembra'.
return -> significa 'retorno'.
right -> significa 'direita'.
road -> significa 'estrada'.
run -> significa 'correr'.
safe -> significa 'seguro'.
sample -> significa 'amostra'.
sand -> significa 'areia'.
say -> significa 'dizer'.
search -> significa 'procura'.
see -> significa 'ver'.
seed -> significa 'semente'.
seke -> significa 'interesse'.
sent -> significa 'enviado'.
sheet -> significa 'folha'.
shield -> significa 'escudo'.
shovel -> significa 'pá'.
side -> significa 'lado'.
sing -> significa 'cantar'.
skill -> significa 'habilidade'.
sky -> significa 'céu'.
some -> significa 'algun'.
solve -> significa 'resolver'.
sought -> significa 'procurado'.
speed -> significa 'velocidade'.
split -> significa 'dividir'.
stay -> significa 'ficar'.
staff -> significa 'cajado'.
surround -> significa 'cercar'.
sword -> significa 'espada'.
table -> significa 'mesa'.
take -> significa 'pega'.
text -> significa 'texto'.
the -> significa 'o'.
them -> significa 'eles'.
three -> significa '3'.
too -> significa 'também'.
tool -> significa 'ferramenta'.
try -> significa 'tentar'.
two -> significa '2'.
up -> significa 'acima'.
upper -> significa 'maior'.
use -> significa 'usa'.
walk -> significa 'andar'.
want -> significa 'quero'.
war -> significa 'guerra'.
water -> significa 'água'.
we ->  significa 'nós'.
web -> significa 'rede'.
when -> significa 'quando'.
wide -> significa 'largo'.
wild -> significa 'selvagem'.
will -> significa 'vai'.
with -> significa 'com'.
width -> significa 'largura'.
wise -> significa 'sábio'.
wood -> significa 'madeira'.
word -> significa 'palavra'.
work -> significa 'trabalho'.
wound -> significa 'ferimento'.
you -> significa 'você'.
your -> significa 'seu'/'sua'.